   #########          #####   
## #      #############   #   
 # #   #####     ##       #   
 ###   #   #     #####    #   
     ###   ###    #       ### 
             #    #         # 
###      ###############    ##
# #      #     #      #      
# #      #     #      #####
# #      #     ###    #   ##  
# #######$       ########  #  
#       #               #  ###
#####   #      ## ########   #
    #   #####   ##       ##  #
    #       #    #        #  #
    #####   ######       ##  #
        #                   
