 #################                      
 #            #  #                      
 #            #  ##################     
 #            #            #      #     
 #                         #      #     
 #                ##########      #     
 #                         #      #     
 #  ###########            #      #     
 ###         #                    #     
 #           #                 $  #     
 #           ##      ######       #     
 #                   #            #     
 #                   #            #     
 #                   #            #     
  ###############    ##############   
                #        #                     
                ##########    
                     