   #########          #####   
## #      #############   #   
 # #   #####     ##       #   
 ###   #   #     ######   #   
  #  ###   ###    #   #   ### 
  #  #       #    #   #     # 
###  #   ###############    ##
# #  #   #     #      #      #
# ####   #     #      ########
# #      #     ###    #   ##  
# ########       ########  #  
#       #               #  ###
#####   #      ###########   #
    #   #####   ##       ##  #
    #       #    #        #  #
    #####   ######       ##  #
        $                   
