		#
#########    ############
##################	#
# # # # #   #		#
# # # # #   $		#
# #######   #	  ########## 
##     #    #######        # 
#      ######	#########  #
###	 ##	  ##	####
  ###	 #	###	#
    #####################
    ##		#
    ###		#     ######
      ## 	#     #    #
################################
#	#		   #	
#	#		   #
###############		####
