   #########          #####   
## #      #############   #   
 # #   #####     ##       #   
 ###   #   #     #####    #   
     ###   ###    #       ### 
             #    #         # 
###      #########$#####    ##
# #      #     #      #      
# #      #     #      #####
# #      #     ###    #   ##  
# ########       ########  #  
#       #               #  ###
#####   #      ## ########   #
    #   #####   ##       ##  #
    #       #    #        #  #
    #####   ######       ##  #
        #                   
